#! /bin/bash
# vim: set tabstop=4 shiftwidth=4 expandtab filetype=sh:

alias a2server-help="more /usr/local/etc/a2server-help.txt"
alias a2server-setup='wget -q -O /tmp/a2server-setup ${A2SERVER_SCRIPT_URL:-https://raw.githubusercontent.com/RasppleII/a2server/current/}setup/index.txt || { echo "Can'"'"'t download A2SERVER setup scripts. Do you has internet?"; false; } && source /tmp/a2server-setup'

alias a2server-version="cat /usr/local/etc/A2SERVER-version"
alias a2server-update='wget -q -O /tmp/a2server-update ${A2SERVER_SCRIPT_URL:-https://raw.githubusercontent.com/RasppleII/a2server/current/}update/index.txt || { echo "Can'"'"'t download A2SERVER setup scripts. Do you has internet?"; false; } && source /tmp/a2server-update'

alias system-shutdown='sudo shutdown -h now'
alias system-restart='sudo shutdown -r now'


alias raspi-config='[[ -f /usr/bin/raspi-config ]] && sudo /usr/bin/raspi-config || echo "raspi-config not found. Are you using a Raspberry Pi with Raspbian?"'
alias raspbian-update='wget -qO /tmp/raspbian-update ${A2SERVER_SCRIPT_URL:-https://raw.githubusercontent.com/RasppleII/a2server/current/}scripts/raspbian-update.txt || { echo "Can'"'"'t download A2SERVER setup scripts. Do you has internet?"; false; } && source /tmp/raspbian-update'
alias rasppleii-update='raspbian-update a2cloud a2server'

alias welcome-message-edit='sudo nano /etc/motd'

alias showip='ip a show dev enp0s3 | grep "inet " | cut -dt -f2 | cut -db -f1'
alias showmac='ip a show dev enp0s3 | grep "link/ether" | cut -dr -f2 | cut -db -f1'
alias showip-wifi='ip a show dev wlan0 | grep "inet " | cut -dt -f2 | cut -db -f1'
alias showmac-wifi='ip a show dev wlan0 | grep "link/ether" | cut -dr -f2 | cut -db -f1'

alias netatalk-stop="sudo systemctl stop atalkd afpd papd timelord a2boot macipgw; bonjour-off"
alias netatalk-start="sudo systemctl start atalkd afpd papd timelord a2boot macipgw &> /dev/null; bonjour-on"
alias netatalk-restart="sudo systemctl restart atalkd  afpd papd timelord a2boot macipgw &> /dev/null; bonjour-on"
alias netatalk-off='sudo systemctl stop atalkd afpd papd timelord a2boot macipgw; sudo systemctl disable atalkd afpd papd a2boot timelord macipgw'
alias netatalk-on='bonjour-on; sudo systemctl enable atalkd afpd papd a2boot timelord macipgw'

alias bonjour-off="sudo mv /etc/avahi/services/afpd.service /etc/avahi/services/afpd.service_disabled &> /dev/null"
alias bonjour-on="sudo mv /etc/avahi/services/afpd.service_disabled /etc/avahi/services/afpd.service &> /dev/null"


#alias netatalk-router-on='sudo sed -i '"'"'s/^\([^# ]*\)\( .*\)$/\1 -router\2 -zone "A2SERVER"/'"'"' /usr/local/etc/netatalk/atalkd.conf; netatalk-restart'
#alias netatalk-router-off='sudo sed -i '"'"'s/^\([^#].*\) -router\(.*\) -zone [^ ]*\(.*\)$/\1\2\3/'"'"' /usr/local/etc/netatalk/atalkd.conf; netatalk-restart'


alias netatalk-eth='sudo sed -i 's/^wlan0/enp0s3/' /usr/local/etc/netatalk/atalkd.conf; netatalk-restart'
alias netatalk-wifi='sudo sed -i 's/^enp0s3/wlan0/' /usr/local/etc/netatalk/atalkd.conf; netatalk-restart'


NETATALK="/usr/local/etc/netatalk"
A2FILES="/srv/A2SERVER/A2FILES"
GSFILES="/srv/A2SERVER/GSFILES"

alias netboot-gsos="mkatinit -gs -d -f"
alias netboot-gsos-guest="mkatinit -gs -d -f guest"
alias netboot-p8="mkatinit -d -f"
alias netboot-p8-guest="mkatinit -d -f guest"




alias guest-off="sudo sed -i 's/uams_guest.so,//' /usr/local/etc/netatalk/afpd.conf; [[ -f /etc/samba/smb.conf ]] && sudo sed -i 's/^    guest ok = yes/    guest ok = no/' /etc/samba/smb.conf; netatalk-restart"
alias guest-on="sudo sed -i 's/-uamlist uams_clrtxt.so/-uamlist uams_guest.so,uams_clrtxt.so/' /usr/local/etc/netatalk/afpd.conf; [[ -f /etc/samba/smb.conf ]] && sudo sed -i 's/^    guest ok = no/    guest ok = yes/' /etc/samba/smb.conf; netatalk-restart"


alias samba-off='sudo systemctl stop smbd nmbd; sudo systemctl disable smbd nmbd &> /dev/null'
alias samba-on='sudo systemctl enable smbd nmbd &> /dev/null; sudo systemctl start smbd nmbd'
alias samba-stop='sudo systemctl stop smbd nmbd'
alias samba-start='sudo systemctl start smbd nmbd'
alias samba-restart='sudo systemctl restart smbd nmbd'

alias a2files-share="sudo sed -i 's/^#share2/\/srv\/A2SERVER\/A2FILES\ A2FILES options:prodos ea:ad/' /usr/local/etc/netatalk/AppleVolumes.default; [[ -d /srv/A2SERVER/A2FILES ]] || mkdir /srv/A2SERVER/A2FILES"
alias a2files-unshare="sudo sed -i 's/^\/srv\/A2SERVER\/A2FILES.*$/#share2/' /usr/local/etc/netatalk/AppleVolumes.default"

alias showalias="alias | cut -d= -f 1 | cut -d' ' -f2 | more"








#
